00000000000000000000000000
00001111111111111111110000
00001111110011111111111000
00000110110011111111111000
00000110111011111111111000
00001110111111111111110000
00011111111111100011100000
00111111111111000001100000
00111111111110000001100000
00111111111110000001100000
00011111111111000011110000
00001111111111111111111100
00000111111111111111111100
00000000000000000000000000